You find yourself alone in a small abandoned cabin. You can't recall how you got here. You stand up to observe your surroundings.  It's quiet... too quiet... 
theStory
An Interactive Fiction by Stuart Woodbury
Release 1 / Serial number 141011 / Inform 7 build 6L38 (I6/v6.33 lib 6/12N) SD

Cabin
You stand in a wooden cabin. You see a door on the east of the cabin.

A butter knife lies on the floor.

You can also see a prism here.

>eat knife
(first taking the butter knife)
Yum!

>take prism
Taken.

>drop prism
Dropped.

>drop knife
You can't see any such thing.

>go east
 What the? How did I get here, I don't remember coming to a jungle!!

(first opening the Cabin Door)

The Jungle
You enter a dense jungle.  There is two mysterious narrow pathways, one leading to the north and one leading to the east.

A ray of sunlight passing through the trees  elluminates an edelwiss flower.

>get edlewiss
You can't see any such thing.

>get edelwiss
You can't see any such thing.

>get edelwiss flower
You can't see any such thing.

* * *

You find yourself alone in a small abandoned cabin. You can't recall how you got here. You stand up to observe your surroundings.  It's quiet... too quiet... 
theStory
An Interactive Fiction by Stuart Woodbury
Release 1 / Serial number 141011 / Inform 7 build 6L38 (I6/v6.33 lib 6/12N) SD

Cabin
You stand in a wooden cabin. You see a door on the east of the cabin.

A butter knife lies on the floor.

You can also see a prism here.

>get all
butter knife: Your hand is now greasy. Gross!
prism: Taken.

>open door
You open the Cabin Door.

>east
 What the? How did I get here, I don't remember coming to a jungle!!

The Jungle
You enter a dense jungle.  You cannot see very far in front of you, though it seems you would be heading east. It is probably not safe to go that way. perhaps you should try for a better view.

A ray of sunlight passing through the trees  illuminates an edelweiss flower.

>get edelweiss
You firmly grasp the base of the stem and pluck the flower, leaving the roots behind. This beautiful flower will surely die.

>up
You grasp a thick vine and, pulling down, press the bottoms of your feet into the truck of a tree. putting one hand over the other, you commence to walk up the tree. hopefully your grip does not slip, from, perchance, your hand being greasy, for surely you would plummet to your death! HAHAHA

>enter cave
(first opening the Cave Entrance)

Cave
It's very dark in here. Perhaps i should light a fire

You can see a pickle, a helmet and a statue here.

>light fire
You light a fire. The cave is illuminated. You hear a strange sound! is something coming? you had better wait twice

>down
You can't go that way.

>look
Cave
It's very dark in here

>look
Cave
It's very dark in here

* * *

>light fire
You light a fire. The cave is illuminated. You hear a strange sound! is something coming? you had better wait twice

>wait
Time passes.

>wait
Time passes.

>put edelweiss in fire
This dangerous act would achieve little.

>show prism to pickle
The pickle is unimpressed.

>attach helmet to statue
You would achieve nothing by this.

>exit cave
I only understood you as far as wanting to exit.

>go north
You can't go that way.

* * *

>enter cave
(first opening the Cave Entrance)

Cave
It's very dark in here. Perhaps i should light a fire

You can see a pickle, a helmet and a statue here.

>look
Canopy
You see a cave here. Why is a cave in the canopy? You look around and while there is a beautiful view, you cannot see below the canopy and all the other branches are too far away for you to go anywhere else except into the cave

>enter cave
You can't see any such thing.

>cave
That's not a verb I recognise.

>east
You can't go that way.

>west
You can't go that way.

* * *

>enter cave
(first opening the Cave Entrance)

Cave
It's very dark in here. Perhaps i should light a fire

You can see a pickle, a helmet and a statue here.

>cave
That's not a verb I recognise.

>north
You can't go that way.

* * *

>east
 What the? How did I get here, I don't remember coming to a jungle!!

The Jungle
You enter a dense jungle.  You cannot see very far in front of you, though it seems you would be heading east. It is probably not safe to go that way. perhaps you should try for a better view.

A ray of sunlight passing through the trees  illuminates an edelweiss flower.

>get all
edelweiss flower: You firmly grasp the base of the stem and pluck the flower, leaving the roots behind. This beautiful flower will surely die.

>up
You grasp a thick vine and, pulling down, press the bottoms of your feet into the truck of a tree. putting one hand over the other, you commence to walk up the tree. hopefully your grip does not slip, from, perchance, your hand being greasy, for surely you would plummet to your death! HAHAHA

>enter cave
(first opening the Cave Entrance)

Cave
It's very dark in here. Perhaps i should light a fire

You can see a helmet, a statue and a pickle here.

>light fire
You light a fire. The cave is illuminated. You hear a strange sound! is something coming? you had better wait twice

>show prism to pickle
You can only do that to something animate.

* * *

>get all
butter knife: Your hand is now greasy. Gross!
prism: Taken.

>look prism
Pretty colors

>look room
You can't see any such thing.

>look cabin
You see nothing special about the Cabin Door.

* * *

>get all
butter knife: Your hand is now greasy. Gross!
prism: Taken.

>east
 What the? How did I get here, I don't remember coming to a jungle!!

(first opening the Cabin Door)

The Jungle
You enter a dense jungle.  You cannot see very far in front of you, though it seems you would be heading east. It is probably not safe to go that way. perhaps you should try for a better view.

A ray of sunlight passing through the trees  illuminates an edelweiss flower.

>get all
edelweiss flower: You firmly grasp the base of the stem and pluck the flower, leaving the roots behind. This beautiful flower will surely die.

* * *

>up
You grasp a thick vine and, pulling down, press the bottoms of your feet into the truck of a tree. putting one hand over the other, you commence to walk up the tree. hopefully your grip does not slip, from, perchance, your hand being greasy, for surely you would plummet to your death! HAHAHA

>enter cave
(first opening the Cave Entrance)

Cave
It's very dark in here. Perhaps i should light a fire

>light fire
You light a fire. The cave is illuminated. You hear a strange sound! is something coming? you had better wait twice

* * *

>wait
Time passes.

>put edelewiss in fire
You can't see any such thing.

>inventory
You are carrying:
  an edelweiss flower
  a prism
  a butter knife

>put edelweiss flower in fire
You can't see any such thing.

>put edelweiss in fire
You can't see any such thing.

* * *

>light fire
You light a fire. The cave is illuminated. You hear a strange sound! is something coming? you had better wait twice

>drop edelewiss
You can't see any such thing.

>i
You are carrying:
  an edelweiss flower
  a prism
  a butter knife

>drop edelweiss
You draw the flower from your knapsack; letting your hand drop, you release the flower, which floats towards the soil. If only it still had its roots, i could have done a transplant.

* * *

>enter cave
(first opening the Cave Entrance)

Cave
It's very dark in here. Perhaps i should light a fire

>light ifre
You can't see any such thing.

>light fier
You can't see any such thing.

>light fire
You light a fire. The cave is illuminated. You hear a strange sound! is something coming? you had better wait twice

>put edelweiss in fire
You can't see any such thing.

>i
You are carrying:
  an edelweiss flower
  a prism
  a butter knife

>put edelweiss in fire
You can't see any such thing.

>light fire
You light a fire. The cave is illuminated. You hear a strange sound! is something coming? you had better wait twice

* * *

>up
You grasp a thick vine and, pulling down, press the bottoms of your feet into the truck of a tree. putting one hand over the other, you commence to walk up the tree. hopefully your grip does not slip, from, perchance, your hand being greasy, for surely you would plummet to your death! HAHAHA

>east
You can't go that way.

>enter cave
(first opening the Cave Entrance)

Cave
It's very dark in here. Perhaps i should light a fire

>get a
You can't see any such thing.

>light fire
You light a fire. The cave is illuminated. You hear a strange sound! is something coming? you had better wait twice

>i
You are carrying:
  an edelweiss flower
  a prism
  a butter knife

>put edelweiss in fire
This dangerous act would achieve little.

>burn edeleweiss
You can't see any such thing.

>burn edelweiss
This dangerous act would achieve little.

>put butter in fire
This dangerous act would achieve little.

* * *

>up
You grasp a thick vine and, pulling down, press the bottoms of your feet into the truck of a tree. putting one hand over the other, you commence to walk up the tree. hopefully your grip does not slip, from, perchance, your hand being greasy, for surely you would plummet to your death! HAHAHA

>light fire
You light a fire. The cave is illuminated. You hear a strange sound! is something coming? you had better wait twice

>put knife in fire
This dangerous act would achieve little.

* * *

>east
 What the? How did I get here, I don't remember coming to a jungle!!

(first opening the Cabin Door)

The Jungle
You enter a dense jungle.  You cannot see very far in front of you, though it seems you would be heading east. It is probably not safe to go that way. perhaps you should try for a better view.

A ray of sunlight passing through the trees  illuminates an edelweiss flower.

>up
You grasp a thick vine and, pulling down, press the bottoms of your feet into the truck of a tree. putting one hand over the other, you commence to walk up the tree. hopefully your grip does not slip, from, perchance, your hand being greasy, for surely you would plummet to your death! HAHAHA

* * *

>light fire
You light a fire. The cave is illuminated. You hear a strange sound! is something coming? you had better wait twice

>put prism in fire
This dangerous act would achieve little.

>put prism in fire
This dangerous act would achieve little.

* * *

>get all
butter knife: Your hand is now greasy. Gross!
prism: Taken.

>eaast
That's not a verb I recognise.

>east
 What the? How did I get here, I don't remember coming to a jungle!!

(first opening the Cabin Door)

The Jungle
You enter a dense jungle.  You cannot see very far in front of you, though it seems you would be heading east. It is probably not safe to go that way. perhaps you should try for a better view.

A ray of sunlight passing through the trees  illuminates an edelweiss flower.

* * *

>up
You grasp a thick vine and, pulling down, press the bottoms of your feet into the truck of a tree. putting one hand over the other, you commence to walk up the tree. hopefully your grip does not slip, from, perchance, your hand being greasy, for surely you would plummet to your death! HAHAHA

>ente cave
That's not a verb I recognise.

>enter cave
(first opening the Cave Entrance)

Cave
It's very dark in here. Perhaps i should light a fire

* * *

>put knife in fire
This dangerous act would achieve little.

>clear
What do you want to clear?

>all
You can't use multiple objects with that verb.

>clear screen
You can't see any such thing.

>clear
What do you want to clear?

>screen
You can't see any such thing.

>go tohell motherfucker
You can't see any such thing.

* * *

You find yourself alone in a small abandoned cabin. You can't recall how you got here. You stand up to observe your surroundings.  It's quiet... too quiet... 
theStory
An Interactive Fiction by Stuart Woodbury
Release 1 / Serial number 141011 / Inform 7 build 6L38 (I6/v6.33 lib 6/12N) SD

Cabin
You stand in a wooden cabin. You see a door on the east of the cabin.

A butter knife lies on the floor.

You can also see a prism here.

>open door
You open the Cabin Door.

>east
 What the? How did I get here, I don't remember coming to a jungle!!

The Jungle
You enter a dense jungle.  There is two mysterious narrow pathways, one leading to the north and one leading to the east.

A ray of sunlight passing through the trees  elluminates an edelwiss flower.

You can also see an edelwiss here.

>get edelwiss
Taken.

* * *

You find yourself alone in a small abandoned cabin. You can't recall how you got here. You stand up to observe your surroundings.  It's quiet... too quiet... 
theStory
An Interactive Fiction by Stuart Woodbury
Release 1 / Serial number 141011 / Inform 7 build 6L38 (I6/v6.33 lib 6/12N) SD

Cabin
You stand in a wooden cabin. You see a door on the east of the cabin.

A butter knife lies on the floor.

You can also see a prism here.

>east
 What the? How did I get here, I don't remember coming to a jungle!!

(first opening the Cabin Door)

The Jungle
You enter a dense jungle.  You cannot see very far in front of you, though it seems you would be heading east. It is probably not safe to go that way. perhaps you should try for a better view.

A ray of sunlight passing through the trees  illuminates an edelweiss flower.

>west
Cabin
You stand in a wooden cabin. You see a door on the east of the cabin.

A butter knife lies on the floor.

You can also see a prism here.

>east
The Jungle
You enter a dense jungle.  There is two mysterious narrow pathways, one leading to the north and one leading to the east.

A ray of sunlight passing through the trees  illuminates an edelweiss flower.

>east
A mysterious figure jumps out from a behind a tree and puts an arrow into your skull

    *** You have died ***

Would you like to RESTART, RESTORE a saved game, QUIT or UNDO the last command?

* * *

>east
 What the? How did I get here, I don't remember coming to a jungle!!

(first opening the Cabin Door)

The Jungle
You enter a dense jungle.  You cannot see very far in front of you, though it seems you would be heading east. It is probably not safe to go that way. perhaps you should try for a better view.

A ray of sunlight passing through the trees  illuminates an edelweiss flower.

>north
You can't go that way.

* * *

>up
You grasp a thick vine and, pulling down, press the bottoms of your feet into the truck of a tree. putting one hand over the other, you commence to walk up the tree. hopefully your grip does not slip, from, perchance, your hand being greasy, for surely you would plummet to your death! HAHAHA

>down
The Jungle
You enter a dense jungle.  You cannot see very far in front of you, though it seems you would be heading west. It is probably not safe to go that way. perhaps you should try for a better view.

A ray of sunlight passing through the trees  illuminates an edelweiss flower.

>west
Cabin
You stand in a wooden cabin. You see a door on the east of the cabin.

A butter knife lies on the floor.

You can also see a prism here.

>east
The Jungle
You enter a dense jungle.  You cannot see very far in front of you, though it seems you would be heading west. It is probably not safe to go that way. perhaps you should try for a better view.

A ray of sunlight passing through the trees  illuminates an edelweiss flower.

>east
A mysterious figure jumps out from a behind a tree and puts an arrow into your skull

    *** You have died ***

Would you like to RESTART, RESTORE a saved game, QUIT or UNDO the last command?

* * *

>enter cave
(first opening the Cave Entrance)

Cave
It's very dark in here. Perhaps i should light a fire

You can see a helmet, a statue and a pickle here.

>look
Canopy
You see a cave here. Why is a cave in the canopy? You look around and while there is a beautiful view, you cannot see below the canopy and all the other branches are too far away for you to go anywhere else except into the cave

>examine
(the Cave Entrance)
You see nothing special about the Cave Entrance.

>fire
That's not a verb I recognise.

>take fire
You can't see any such thing.

* * *

>Light Fiure
You can't see any such thing.

* * *

>enter cave
(first opening the Cave Entrance)

Cave
It's very dark in here. Perhaps i should light a fire

You can see a helmet, a statue and a pickle here.

>Light Fire
You light a fire. The cave is illuminated.

* * *

>enter cave
(first opening the Cave Entrance)

Cave
It's very dark in here. Perhaps i should light a fire

You can see a helmet, a statue and a pickle here.

>exit cave
I only understood you as far as wanting to exit.

>exit
But you aren't in anything at the moment.

>i
You are carrying nothing.

>get helmet
Taken.

>put helmet in fire
This dangerous act would achieve little.

>clear
(the helmet)
Nothing obvious happens.

>go north
You can't go that way.

* * *

>enter cave
(first opening the Cave Entrance)

Cave
It's very dark in here. Perhaps i should light a fire

You can see a helmet, a statue and a pickle here.

>attach helmet to statue
You would achieve nothing by this.

* * *

>up
You grasp a thick vine and, pulling down, press the bottoms of your feet into the truck of a tree. putting one hand over the other, you commence to walk up the tree. hopefully your grip does not slip, from, perchance, your hand being greasy, for surely you would plummet to your death! HAHAHA

>look
Canopy
You see a cave here. Why is a cave in the canopy? You look around and while there is a beautiful view, you cannot see below the canopy and all the other branches are too far away for you to go anywhere else except into the cave

>clear
What do you want to clear?

* * *

>up
You grasp a thick vine and, pulling down, press the bottoms of your feet into the truck of a tree. putting one hand over the other, you commence to walk up the tree. hopefully your grip does not slip, from, perchance, your hand being greasy, for surely you would plummet to your death! HAHAHA

>north
The Village
The village is a nasty, rundown, cesspool. The inhabitants do not look very friendly. You must be in east Baltimore

>south
Canopy
You see a cave here. Why is a cave in the canopy? You look around and while there is a beautiful view, you cannot see below the canopy and all the other branches are too far away for you to go anywhere else except into the cave

>go north
The Village
The village is a nasty, rundown, cesspool. The inhabitants do not look very friendly. You must be in east Baltimore

>south
Canopy
You see a cave here. Why is a cave in the canopy? You look around and while there is a beautiful view, you cannot see below the canopy and all the other branches are too far away for you to go anywhere else except into the cave

>down
The Jungle
You enter a dense jungle.  You cannot see very far in front of you, though it seems you would be heading east. It is probably not safe to go that way. perhaps you should try for a better view.

A ray of sunlight passing through the trees  illuminates an edelweiss flower.

>west
Cabin
You stand in a wooden cabin. You see a door on the east of the cabin.

A butter knife lies on the floor.

You can also see a prism here.

>open door
That's already open.

>close door
You close the Cabin Door.

>exit cabin
I only understood you as far as wanting to exit.

>exit
But you aren't in anything at the moment.

>go to hell
You can't see any such thing.

>die
That's not a verb I recognise.

>duck you
That's not a verb I recognise.

>fuck you
That's not a verb I recognise.

>gitch
That's not a verb I recognise.

* * *

You find yourself alone in a small abandoned cabin. You can't recall how you got here. You stand up to observe your surroundings.  It's quiet... too quiet... 
theStory
An Interactive Fiction by Stuart Woodbury
Release 1 / Serial number 141011 / Inform 7 build 6L38 (I6/v6.33 lib 6/12N) SD

Cabin
You stand in a wooden cabin. You see a door on the east of the cabin.

A butter knife lies on the floor.

You can also see a prism here.

>take all
butter knife: Your hand is now greasy. Gross!
prism: Taken.

>open door
You open the Cabin Door.

* * *

>east
 What the? How did I get here, I don't remember coming to a jungle!!

The Jungle
You enter a dense jungle.  You cannot see very far in front of you, though it seems you would be heading east. It is probably not safe to go that way. perhaps you should try for a better view.

A ray of sunlight passing through the trees  illuminates an edelweiss flower.

>east
You fall victim to a bear trap, which clamps over your leg, snapping your femur. you scream in agony, blood gushing onto the soft brown soil. a white man appears. HELP ME! you scream. the man approaches you, procures a knife, and removes your scalp.

    *** You have died ***

Would you like to RESTART, RESTORE a saved game, QUIT or UNDO the last command?

* * *

You find yourself alone in a small abandoned cabin. You can't recall how you got here. You stand up to observe your surroundings.  It's quiet... too quiet... 
theStory
An Interactive Fiction by Stuart Woodbury
Release 1 / Serial number 141011 / Inform 7 build 6L38 (I6/v6.33 lib 6/12N) SD

Cabin
You stand in a wooden cabin. You see a door on the east of the cabin.

A butter knife lies on the floor.

You can also see a prism here.

>wait
Time passes.

* * *

You find yourself alone in a small abandoned cabin. You can't recall how you got here. You stand up to observe your surroundings.  It's quiet... too quiet... 
theStory
An Interactive Fiction by Stuart Woodbury
Release 1 / Serial number 141011 / Inform 7 build 6L38 (I6/v6.33 lib 6/12N) SD

Cabin
You stand in a wooden cabin. You see a door on the east of the cabin.

A butter knife lies on the floor.

You can also see a prism here.

>ujp
That's not a verb I recognise.

>up
You can't go that way.

>east
 What the? How did I get here, I don't remember coming to a jungle!!

(first opening the Cabin Door)

The Jungle
You enter a dense jungle.  You cannot see very far in front of you, though it seems you would be heading east. It is probably not safe to go that way. perhaps you should try for a better view.

A ray of sunlight passing through the trees  illuminates an edelweiss flower.

* * *

>up
You grasp a thick vine and, pulling down, press the bottoms of your feet into the truck of a tree. putting one hand over the other, you commence to walk up the tree. hopefully your grip does not slip, from, perchance, your hand being greasy, for surely you would plummet to your death! HAHAHA

>enter cave
You can't see any such thing.

>east
Cave
You see a cave here. Why is a cave in the canopy? You look around and while there is a beautiful view, you cannot see below the canopy and all the other branches are too far away for you to go anywhere else except into the cave

You can see a helmet, a statue and a pickle here.

>enter cave
You can't see any such thing.

* * *

You find yourself alone in a small abandoned cabin. You can't recall how you got here. You stand up to observe your surroundings.  It's quiet... too quiet... 
theStory
An Interactive Fiction by Stuart Woodbury
Release 1 / Serial number 141011 / Inform 7 build 6L38 (I6/v6.33 lib 6/12N) SD

Cabin
You stand in a wooden cabin. You see a door on the east of the cabin.

A butter knife lies on the floor.

You can also see a prism here.

>attach butter knife to prism
You would achieve nothing by this.

>get prism
Taken.

>show prism to butter knife
You can only do that to something animate.